111110010011111
111000210100111
110012201010011
100010010101001
101121101010100
002011010101011
022010101010220
110101010110200
001010101121101
100101010010001
110010102210011
111001012000111
111110010011111